/html	localeFilterList="*"	localeFilterType="include"
/html/head[1]	localeFilterList="*"	localeFilterType="include"
/html/head[1]/meta[1]	localeFilterList="*"	localeFilterType="include"
/html/head[1]/meta[1]/@charset	localeFilterList="*"	localeFilterType="include"
/html/head[1]/title[1]	localeFilterList="*"	localeFilterType="include"
/html/body[1]	localeFilterList="*"	localeFilterType="include"
/html/body[1]/div[1]	localeFilterList="*-ca"	localeFilterType="include"
/html/body[1]/div[1]/@its-locale-filter-list	localeFilterList="*-ca"	localeFilterType="include"
/html/body[1]/div[1]/p[1]	localeFilterList="*-ca"	localeFilterType="include"
/html/body[1]/div[2]	localeFilterList="*-ca"	localeFilterType="exclude"
/html/body[1]/div[2]/@its-locale-filter-list	localeFilterList="*-ca"	localeFilterType="exclude"
/html/body[1]/div[2]/@its-locale-filter-type	localeFilterList="*-ca"	localeFilterType="exclude"
/html/body[1]/div[2]/p[1]	localeFilterList="*-ca"	localeFilterType="exclude"
/html/body[1]/div[3]	localeFilterList="*"	localeFilterType="exclude"
/html/body[1]/div[3]/@its-locale-filter-list	localeFilterList="*"	localeFilterType="exclude"
/html/body[1]/div[3]/@its-locale-filter-type	localeFilterList="*"	localeFilterType="exclude"
/html/body[1]/div[3]/p[1]	localeFilterList="*"	localeFilterType="exclude"
/html/body[1]/div[4]	localeFilterList=""	localeFilterType="exclude"
/html/body[1]/div[4]/@its-locale-filter-list	localeFilterList=""	localeFilterType="exclude"
/html/body[1]/div[4]/@its-locale-filter-type	localeFilterList=""	localeFilterType="exclude"
/html/body[1]/div[4]/p[1]	localeFilterList=""	localeFilterType="exclude"
